






111111
100CE1
1C0PC1
100001
100001
111111
